SOURCELONG:Player's Handbook	SOURCESHORT:PHB	SOURCEWEB:http://www.gozzilioni.net	SOURCEDATE:2014-08

# Standard
# Language	Type						Var. Min. Value
Common	TYPE:Spoken.Common
Dwarvish	TYPE:Spoken.Dwarvish
Elvish	TYPE:Spoken.Elvish
Giant		TYPE:Spoken.Dwarvish
Gnomish	TYPE:Spoken.Dwarvish
Goblin	TYPE:Spoken.Dwarvish
Halfling	TYPE:Spoken.Common
Orc		TYPE:Spoken.Dwarvish
#Exotic Languages
Abyssal	TYPE:Exotic Language.Spoken.Infernal
Celestial	TYPE:Exotic Language.Spoken.Celestial
Draconic	TYPE:Exotic Language.Spoken.Draconic
Deep Speech	TYPE:Exotic Language.Spoken.NoScript
Infernal	TYPE:Exotic Language.Spoken.Infernal
Primordial	TYPE:Exotic Language.Spoken.Dwarvish
Sylvan	TYPE:Exotic Language.Spoken.Elvish
Undercommon	TYPE:Exotic Language.Spoken.Elvish

Druidic	TYPE:Spoken.Druid.Secret.Druidic	PREVARGTEQ:DruidicLanguage,1

Celestial (Understands)	TYPE:Understands
Common (Understands)	TYPE:Understands
Elvish (Understands)	TYPE:Understands
Sylvan (Understands)	TYPE:Understands
