SOURCELONG:Complete Warrior	SOURCESHORT:CW	SOURCEWEB:http://www.gozzilioni.net	SOURCEDATE:2003-11																														
#																																							
# Spell Name	OUTPUTNAME:	key	VARIANTS:	TYPE:	SCHOOL:	SUBSCHOOL:	DESCRIPTOR:	CLASSES:	COMPS:	CASTTIME:	RANGE:	TARGETAREA:	DURATION:	SAVEINFO:	SPELLRES:	DESC:	SOURCEPAGE:	Item	COST:	XPCOST:	PPCOST	DESC:|!PRERULE:1,DisplayFullSpell	Desc	Bonus	Bonus														
#
Magic Stone.MOD	CLASSES:Hunter of the Dead=1
Magic Weapon.MOD	CLASSES:Hunter of the Dead=1
Cure Light Wounds.MOD	CLASSES:Hunter of the Dead=1
Hide from Undead.MOD	CLASSES:Hunter of the Dead=1
Remove Fear.MOD	CLASSES:Hunter of the Dead=1
Bull's Strength.MOD	CLASSES:Hunter of the Dead=2
Cure Moderate Wounds.MOD	CLASSES:Hunter of the Dead=2
Continual Flame.MOD	CLASSES:Hunter of the Dead=2
Darkvision.MOD	CLASSES:Hunter of the Dead=2
Restoration (Lesser).MOD	CLASSES:Hunter of the Dead=2
Remove Paralysis.MOD	CLASSES:Hunter of the Dead=2
Cure Serious Wounds.MOD	CLASSES:Hunter of the Dead=3
Daylight.MOD	CLASSES:Hunter of the Dead=3
Halt Undead.MOD	CLASSES:Hunter of the Dead=3
Protection from Elements.MOD	CLASSES:Hunter of the Dead=3
Searing Light.MOD	CLASSES:Hunter of the Dead=3
Speak with Dead.MOD	CLASSES:Hunter of the Dead=3
Cure Critical Wounds.MOD	CLASSES:Hunter of the Dead=4
Death Ward.MOD	CLASSES:Hunter of the Dead=4
Dusrupting Weapon.MOD	CLASSES:Hunter of the Dead=4
Freedom of Movement.MOD	CLASSES:Hunter of the Dead=4
Restoration.MOD	CLASSES:Hunter of the Dead=4
Bless Water.MOD	CLASSES:Knight of the Chalice=1
Bless Weapon.MOD	CLASSES:Knight of the Chalice=1
Detect Chaos.MOD	CLASSES:Knight of the Chalice=1
Detect Evil.MOD	CLASSES:Knight of the Chalice=1
Divine Favor.MOD	CLASSES:Knight of the Chalice=1
Doom.MOD	CLASSES:Knight of the Chalice=1
Endure Elements.MOD	CLASSES:Knight of the Chalice=1
Magic Weapon.MOD	CLASSES:Knight of the Chalice=1
Protection from Evil.MOD	CLASSES:Knight of the Chalice=1
Remove Fear.MOD	CLASSES:Knight of the Chalice=1
Summon Monster I.MOD	CLASSES:Knight of the Chalice=1
Aid.MOD	CLASSES:Knight of the Chalice=2
Align Weapon.MOD	CLASSES:Knight of the Chalice=2
Bull's Strength.MOD	CLASSES:Knight of the Chalice=2
Consecrate.MOD	CLASSES:Knight of the Chalice=2
Endurance.MOD	CLASSES:Knight of the Chalice=2
Resist Elements.MOD	CLASSES:Knight of the Chalice=2
Sound Burst.MOD	CLASSES:Knight of the Chalice=2
Spiritual Weapon.MOD	CLASSES:Knight of the Chalice=2
Summon Monster II.MOD	CLASSES:Knight of the Chalice=2
Undetectable Alignment.MOD	CLASSES:Knight of the Chalice=2
Dispel Magic.MOD	CLASSES:Knight of the Chalice=3
Invisibility Purge.MOD	CLASSES:Knight of the Chalice=3
Magic Circle against Evil.MOD	CLASSES:Knight of the Chalice=3
Magic Vestment.MOD	CLASSES:Knight of the Chalice=3
Prayer.MOD	CLASSES:Knight of the Chalice=3
Protection from Elements.MOD	CLASSES:Knight of the Chalice=3
Searing Light.MOD	CLASSES:Knight of the Chalice=3
Shout.MOD	CLASSES:Knight of the Chalice=3
Summon Monster III.MOD	CLASSES:Knight of the Chalice=3
Dimensional Anchor.MOD	CLASSES:Knight of the Chalice=4
Discern Lies.MOD	CLASSES:Knight of the Chalice=4
Dismissal.MOD	CLASSES:Knight of the Chalice=4
Dispel Evil.MOD	CLASSES:Knight of the Chalice=4
Holy Smite.MOD	CLASSES:Knight of the Chalice=4
Magic Weapon (Greater).MOD	CLASSES:Knight of the Chalice=4
Aspect of the Deity (Lesser).MOD	CLASSES:Knight of the Chalice=4
Planar Ally (Lesser).MOD	CLASSES:Knight of the Chalice=4
