SOURCELONG:Dungeons Master's Guide	SOURCESHORT:DMG	SOURCEWEB:http://www.gozzilioni.net	SOURCEDATE:2003-07
#																								
# Spell Name	OUTPUTNAME:	key	VARIANTS:	TYPE:	SCHOOL:	SUBSCHOOL:	DESCRIPTOR:	CLASSES:	COMPS:	CASTTIME:	RANGE:	TARGETAREA:	DURATION:	SAVEINFO:	SPELLRES:	DESC:|!PRERULE:1,DisplayFullSpell	SOURCEPAGE:	Item	COST:	XPCOST:	PPCOST	Desc	Bonus	Bonus
### Summon Monster I ~ Evil only.MOD	CLASS:.CLEARALL
Summon Monster I.COPY=Summon Monster I	KEY:Summon Monster I ~ Evil only
Summon Monster I ~ Evil only.MOD	OUTPUTNAME:Summon Monster I	DESCRIPTOR:.CLEAR	DESCRIPTOR:Evil	DESC:Cast as an Evil spell only.	SOURCEPAGE:DMG
Summon Monster IX.COPY=Summon Monster IX	KEY:Summon Monster IX ~ Evil only
Summon Monster IX ~ Evil only.MOD	OUTPUTNAME:Summon Monster IX	DESCRIPTOR:.CLEAR	DESCRIPTOR:Evil	DESC:Cast as an Evil spell only.	SOURCEPAGE:DMG
###TODO:Resist Energy ~ Electricity.MOD	CLASS:.CLEARALL
Resist Energy.COPY=Resist Energy	KEY:Resist Energy ~ Electricity
Resist Energy ~ Electricity.MOD	TYPE:SpellLike	DESC:Electricity Only.	SOURCEPAGE:DMG
###TODO:Resist Energy ~ Fire.MOD	CLASS:.CLEARALL
Resist Energy.COPY=Resist Energy	KEY:Resist Energy ~ Fire
Resist Energy ~ Fire.MOD	TYPE:SpellLike	DESC:Fire Only.	SOURCEPAGE:DMG
###TODO:Air Walk ~ Self only	CLASS:.CLEARALL
Air Walk.COPY=Air Walk	KEY:Air Walk ~ Self only
Air Walk ~ Self only.MOD	TYPE:SpellLike	TARGETAREA:.CLEAR	TARGETAREA:You.	DESC:Self only.	SOURCEPAGE:DMG
###TODO:Stoneskin ~ Self only.MOD	CLASS:.CLEARALL
Stoneskin.COPY=Stoneskin	KEY:Stoneskin ~ Self only
Stoneskin ~ Self only.MOD	TYPE:SpellLike	TARGETAREA:.CLEAR	TARGETAREA:You.	DESC:Self only.	SOURCEPAGE:DMG
#
###TODO:Orb of Dragonkind ~ Domination.MOD	CLASS:.CLEARALL
Dominate Monster.COPY=Dominate Monster	KEY:Orb of Dragonkind ~ Domination
Orb of Dragonkind ~ Domination.MOD	OUTPUTNAME:Domination	TYPE:SpellLike	SOURCEPAGE:DMG
###TODO:Shadowdancer ~ Silent Image.MOD	CLASS:.CLEARALL
Silent Image.COPY=Silent Image	KEY:Shadowdancer ~ Silent Image
Shadowdancer ~ Silent Image.MOD	OUTPUTNAME:Shadow Illusion	TYPE:SpellLike	DESC:Create visual illusions from surrounding shadows.	SOURCEPAGE:DMG
